//MAP CONVERTED BY dmm2tgm.py THIS HEADER COMMENT PREVENTS RECONVERSION, DO NOT REMOVE
"af" = (
/obj/effect/turf_decal/techfloor/corner{
	dir = 8
	},
/turf/open/floor/engine/hull/reinforced,
/area/ship/external)
"ar" = (
/obj/machinery/power/smes/shuttle/precharged{
	dir = 4
	},
/obj/machinery/door/window/eastleft,
/obj/machinery/door/poddoor/preopen{
	id = "hotrod_thruster_blast";
	name = "thruster blast door";
	dir = 4
	},
/obj/structure/catwalk/over,
/obj/structure/cable/cyan{
	icon_state = "0-8"
	},
/turf/open/floor/plating,
/area/ship/engineering/engine)
"aV" = (
/obj/structure/window/reinforced,
/obj/structure/curtain/bounty,
/obj/structure/table/reinforced,
/obj/item/reagent_containers/food/drinks/bottle/hcider,
/obj/item/reagent_containers/food/drinks/bottle/lizardwine,
/obj/item/reagent_containers/food/drinks/bottle/wine,
/obj/item/reagent_containers/food/snacks/grown/citrus/lemon,
/obj/item/reagent_containers/food/snacks/energybar,
/obj/item/reagent_containers/food/snacks/energybar,
/obj/item/reagent_containers/food/snacks/energybar,
/obj/item/reagent_containers/food/snacks/grown/mushroom/jupitercup,
/obj/item/reagent_containers/food/snacks/grown/mushroom/jupitercup,
/obj/item/reagent_containers/food/snacks/grown/ash_flora/cactus_fruit,
/obj/item/reagent_containers/food/snacks/grown/ash_flora/cactus_fruit,
/obj/item/reagent_containers/food/snacks/grown/ash_flora/cactus_fruit,
/obj/item/reagent_containers/food/snacks/grown/ash_flora/cactus_fruit,
/obj/effect/turf_decal/techfloor{
	dir = 8
	},
/obj/structure/closet/secure_closet/wall/directional/west{
	name = "Refridgerator"
	},
/turf/open/floor/plasteel/tech,
/area/ship/hallway/central)
"bj" = (
/obj/machinery/door/airlock/hatch{
	name = "Cockpit";
	dir = 4
	},
/obj/structure/cable{
	icon_state = "4-8"
	},
/obj/machinery/atmospherics/pipe/simple/scrubbers/hidden/layer4{
	dir = 4
	},
/obj/machinery/atmospherics/pipe/simple/supply/hidden/layer2{
	dir = 4
	},
/obj/machinery/door/firedoor/border_only{
	dir = 4
	},
/obj/machinery/door/firedoor/border_only{
	dir = 8
	},
/obj/effect/turf_decal/borderfloorblack{
	dir = 4
	},
/obj/effect/turf_decal/borderfloorblack{
	dir = 8
	},
/turf/open/floor/plasteel/tech/grid,
/area/ship/bridge)
"dm" = (
/obj/effect/turf_decal/techfloor/corner{
	dir = 4
	},
/turf/open/floor/engine/hull/reinforced,
/area/ship/external)
"dq" = (
/obj/structure/cable{
	icon_state = "2-9"
	},
/obj/machinery/washing_machine,
/turf/open/floor/plasteel/tech,
/area/ship/engineering/engine)
"dL" = (
/obj/item/clothing/gloves/color/yellow,
/obj/item/storage/toolbox/electrical,
/obj/item/storage/toolbox/mechanical,
/obj/item/multitool,
/obj/item/clothing/glasses/welding,
/obj/item/storage/box/lights/mixed,
/obj/item/storage/backpack/duffelbag/engineering,
/obj/item/storage/bag/construction,
/obj/effect/turf_decal/techfloor{
	dir = 8
	},
/obj/structure/closet/wall/orange/directional/west{
	name = "Tool Locker"
	},
/turf/open/floor/plasteel/tech,
/area/ship/engineering/engine)
"dU" = (
/obj/effect/turf_decal/techfloor,
/turf/open/floor/engine/hull/reinforced,
/area/ship/external)
"em" = (
/obj/structure/sink/kitchen{
	dir = 8;
	pixel_x = 14
	},
/obj/item/reagent_containers/glass/bowl,
/obj/item/reagent_containers/glass/bowl,
/obj/item/kitchen/rollingpin,
/obj/item/kitchen/knife,
/obj/item/reagent_scanner,
/obj/item/reagent_containers/glass/beaker/large,
/obj/item/reagent_containers/glass/beaker/large,
/obj/item/reagent_containers/glass/filter,
/obj/item/reagent_containers/food/drinks/drinkingglass,
/obj/item/reagent_containers/food/drinks/drinkingglass,
/obj/item/reagent_containers/food/drinks/drinkingglass,
/obj/machinery/atmospherics/components/unary/vent_pump/on/layer2{
	dir = 1
	},
/obj/item/storage/bag/tray,
/obj/effect/turf_decal/techfloor{
	dir = 4
	},
/obj/effect/turf_decal/spline/fancy/opaque/black{
	dir = 1
	},
/obj/effect/turf_decal/trimline/transparent/green/corner{
	dir = 1
	},
/obj/structure/closet/secure_closet/wall/directional/east{
	name = "Utinsels Cabinet"
	},
/turf/open/floor/plasteel/tech,
/area/ship/hallway/central)
"eH" = (
/obj/structure/table/reinforced,
/obj/item/radio/intercom/wideband/table{
	dir = 1;
	pixel_y = 4;
	pixel_x = -10
	},
/obj/machinery/atmospherics/components/unary/vent_pump/on/layer2,
/obj/machinery/button/door{
	pixel_x = 6;
	pixel_y = 8;
	name = "Cockpit Shutters";
	id = "hotrod_windows"
	},
/obj/effect/turf_decal/borderfloorblack{
	dir = 5
	},
/obj/effect/turf_decal/trimline/transparent/blue/corner{
	dir = 8
	},
/obj/item/spacecash/bundle/c1000{
	pixel_y = 4;
	pixel_x = -5
	},
/obj/item/spacecash/bundle/c1000{
	pixel_x = -13;
	pixel_y = -1
	},
/obj/item/spacecash/bundle/c500{
	pixel_x = 8;
	pixel_y = 2
	},
/turf/open/floor/plasteel/tech,
/area/ship/bridge)
"fg" = (
/obj/machinery/atmospherics/components/unary/vent_scrubber/on/layer4{
	dir = 1
	},
/obj/machinery/light/directional/west,
/obj/effect/turf_decal/techfloor{
	dir = 8
	},
/obj/effect/turf_decal/spline/fancy/opaque/black{
	dir = 1
	},
/obj/effect/turf_decal/trimline/transparent/green/corner{
	dir = 4
	},
/turf/open/floor/plasteel/tech,
/area/ship/hallway/central)
"fI" = (
/obj/structure/railing{
	dir = 8
	},
/obj/structure/railing{
	dir = 4
	},
/obj/machinery/power/shieldwallgen/atmos/roundstart{
	dir = 1;
	id = "hotrod_holo"
	},
/obj/structure/cable,
/turf/open/floor/plasteel/stairs,
/area/ship/external)
"iD" = (
/obj/structure/cable{
	icon_state = "6-9"
	},
/obj/structure/cable{
	icon_state = "1-6"
	},
/obj/machinery/atmospherics/components/unary/vent_scrubber/on/layer4{
	dir = 4
	},
/obj/effect/turf_decal/trimline/transparent/yellow/line{
	dir = 9
	},
/turf/open/floor/plasteel/tech,
/area/ship/engineering/engine)
"iJ" = (
/obj/machinery/portable_atmospherics/canister/oxygen,
/obj/effect/turf_decal/techfloor{
	dir = 1
	},
/obj/structure/extinguisher_cabinet/directional/north,
/turf/open/floor/plasteel/tech,
/area/ship/engineering/engine)
"ju" = (
/obj/machinery/power/terminal{
	dir = 4
	},
/obj/structure/cable/yellow{
	icon_state = "0-2"
	},
/obj/effect/turf_decal/techfloor/orange{
	dir = 4
	},
/obj/structure/closet/crate/wooden,
/obj/item/stack/sheet/metal/twenty,
/obj/item/stack/sheet/glass/twenty,
/obj/effect/turf_decal/trimline/transparent/yellow/line{
	dir = 8
	},
/obj/item/stack/sheet/plastic/five,
/obj/item/stack/sheet/cotton/cloth/ten,
/turf/open/floor/plasteel/tech,
/area/ship/engineering/engine)
"jG" = (
/obj/structure/window/plasma/reinforced/plastitanium,
/obj/structure/grille,
/obj/machinery/door/poddoor/shutters/preopen{
	id = "hotrod_windows"
	},
/turf/open/floor/plating,
/area/ship/bridge)
"ls" = (
/obj/structure/window/reinforced{
	dir = 1
	},
/obj/structure/curtain/bounty,
/obj/structure/table/wood/reinforced,
/obj/effect/turf_decal/siding/wood{
	dir = 1
	},
/obj/item/paper_bin{
	pixel_x = 8;
	pixel_y = 2
	},
/obj/item/pen{
	pixel_x = 8;
	pixel_y = 2
	},
/obj/item/modular_computer/laptop/preset/civilian,
/turf/open/floor/wood/ebony,
/area/ship/crew/dorm)
"lK" = (
/obj/effect/turf_decal/techfloor/corner{
	dir = 1
	},
/turf/open/floor/engine/hull/reinforced,
/area/ship/external)
"mc" = (
/obj/structure/curtain/bounty,
/obj/structure/table/reinforced,
/obj/structure/window/reinforced{
	dir = 1
	},
/obj/machinery/jukebox/boombox{
	pixel_y = -4;
	pixel_x = -4
	},
/obj/machinery/atmospherics/pipe/layer_manifold,
/turf/open/floor/plasteel/tech,
/area/ship/hallway/central)
"na" = (
/obj/machinery/door/airlock/maintenance_hatch{
	dir = 4;
	name = "Engine"
	},
/obj/structure/cable{
	icon_state = "4-8"
	},
/obj/machinery/atmospherics/pipe/simple/scrubbers/hidden/layer4{
	dir = 4
	},
/obj/machinery/atmospherics/pipe/simple/supply/hidden/layer2{
	dir = 4
	},
/obj/machinery/door/firedoor/border_only{
	dir = 8
	},
/obj/machinery/door/firedoor/border_only{
	dir = 4
	},
/obj/effect/turf_decal/borderfloorblack{
	dir = 4
	},
/obj/effect/turf_decal/borderfloorblack{
	dir = 8
	},
/turf/open/floor/plasteel/tech/grid,
/area/ship/engineering/engine)
"nD" = (
/obj/effect/turf_decal/techfloor/corner,
/turf/open/floor/engine/hull/reinforced,
/area/ship/external)
"oZ" = (
/obj/machinery/button/door{
	pixel_y = -4;
	id = "hotrod_thruster_blast";
	name = "thruster gates";
	pixel_x = -26;
	dir = 4
	},
/obj/effect/turf_decal/techfloor{
	dir = 8
	},
/obj/machinery/firealarm/directional/west{
	pixel_y = 10
	},
/turf/open/floor/plasteel/tech,
/area/ship/engineering/engine)
"px" = (
/obj/structure/window/plasma/reinforced/plastitanium,
/obj/structure/grille,
/obj/machinery/door/poddoor/shutters/preopen{
	id = "hotrod_windows";
	dir = 4
	},
/turf/open/floor/plating,
/area/ship/bridge)
"pG" = (
/obj/structure/catwalk/over,
/obj/machinery/autolathe,
/obj/machinery/atmospherics/pipe/layer_manifold,
/obj/machinery/airalarm/directional/east,
/turf/open/floor/plating,
/area/ship/engineering/engine)
"pS" = (
/obj/structure/catwalk/over/plated_catwalk/dark,
/obj/structure/cable{
	icon_state = "4-8"
	},
/obj/machinery/atmospherics/pipe/simple/scrubbers/hidden/layer4{
	dir = 4
	},
/obj/machinery/atmospherics/pipe/manifold/supply/hidden/layer2,
/obj/structure/cable{
	icon_state = "2-8"
	},
/turf/open/floor/plating,
/area/ship/hallway/central)
"qc" = (
/obj/machinery/power/smes/shuttle/precharged{
	dir = 4
	},
/obj/machinery/door/window/eastright,
/obj/machinery/door/poddoor/preopen{
	id = "hotrod_thruster_blast";
	name = "thruster blast door";
	dir = 4
	},
/obj/structure/catwalk/over,
/obj/structure/cable/cyan{
	icon_state = "0-8"
	},
/turf/open/floor/plating,
/area/ship/engineering/engine)
"qR" = (
/turf/closed/wall/mineral/plastitanium/nodiagonal,
/area/ship/bridge)
"rG" = (
/obj/machinery/power/terminal{
	dir = 8
	},
/obj/structure/cable{
	icon_state = "0-6"
	},
/obj/effect/turf_decal/industrial/warning/fulltile,
/obj/structure/catwalk/over/plated_catwalk/dark,
/turf/open/floor/plating,
/area/ship/engineering/engine)
"tt" = (
/obj/machinery/power/terminal{
	dir = 8
	},
/obj/structure/cable{
	icon_state = "0-5"
	},
/obj/structure/cable{
	icon_state = "5-6"
	},
/obj/effect/turf_decal/industrial/warning/fulltile,
/obj/structure/catwalk/over/plated_catwalk/dark,
/turf/open/floor/plating,
/area/ship/engineering/engine)
"ug" = (
/turf/closed/wall/mineral/plastitanium,
/area/ship/engineering/engine)
"wj" = (
/obj/machinery/door/airlock/grunge{
	name = "Living Quarters"
	},
/obj/structure/cable{
	icon_state = "1-2"
	},
/obj/machinery/atmospherics/pipe/simple/scrubbers/hidden/layer4,
/obj/machinery/atmospherics/pipe/simple/supply/hidden/layer2,
/obj/machinery/door/firedoor/border_only{
	dir = 1
	},
/obj/machinery/door/firedoor/border_only,
/obj/effect/turf_decal/borderfloorblack,
/obj/effect/turf_decal/borderfloorblack{
	dir = 1
	},
/turf/open/floor/plasteel/tech/grid,
/area/ship/crew/dorm)
"zs" = (
/obj/item/cultivator/rake,
/obj/item/shovel/spade,
/obj/item/shovel,
/obj/item/clothing/gloves/botanic_leather,
/obj/item/plant_analyzer,
/obj/item/reagent_containers/glass/bucket/wooden,
/obj/item/seeds/chanter/jupitercup,
/obj/item/seeds/chanter/jupitercup,
/obj/item/seeds/lavaland/cactus,
/obj/item/seeds/lavaland/cactus,
/obj/item/seeds/lavaland/fireblossom,
/obj/item/seeds/lavaland/inocybe,
/obj/item/seeds/random,
/obj/item/seeds/tobacco/space,
/obj/item/stack/sheet/mineral/sandstone/thirty,
/obj/item/seeds/aloe,
/obj/item/seeds/cannabis,
/obj/item/seeds/cannabis,
/obj/item/reagent_containers/glass/bottle/nutrient/ez,
/obj/item/reagent_containers/glass/bottle/nutrient/ez,
/obj/item/reagent_containers/glass/bottle/nutrient/l4z,
/obj/item/reagent_containers/glass/bottle/nutrient/rh,
/obj/item/storage/bag/plants,
/obj/effect/turf_decal/techfloor{
	dir = 1
	},
/obj/structure/closet/secure_closet/wall/directional/north{
	icon_state = "generic_wall";
	name = "Gardening Supplies"
	},
/turf/open/floor/engine/hull/reinforced,
/area/ship/external)
"Bf" = (
/obj/machinery/power/shuttle/engine/electric{
	dir = 4
	},
/obj/structure/catwalk/over,
/obj/structure/cable/cyan{
	icon_state = "0-4"
	},
/turf/open/floor/plating/airless,
/area/ship/external)
"Bv" = (
/obj/effect/turf_decal/techfloor{
	dir = 4
	},
/obj/machinery/computer/helm{
	dir = 8;
	icon_state = "computer-right"
	},
/turf/open/floor/plasteel/telecomms_floor,
/area/ship/bridge)
"BO" = (
/turf/template_noop,
/area/template_noop)
"Co" = (
/obj/machinery/atmospherics/components/unary/vent_pump/on/layer2{
	dir = 4
	},
/obj/machinery/airalarm/directional/west,
/obj/machinery/firealarm/directional/south,
/obj/effect/turf_decal/siding/wood{
	dir = 10
	},
/obj/structure/chair/comfy/red/directional/east,
/turf/open/floor/wood/ebony,
/area/ship/crew/dorm)
"CI" = (
/obj/machinery/power/terminal{
	dir = 8
	},
/obj/structure/cable{
	icon_state = "0-6"
	},
/obj/machinery/light/small/directional/north,
/obj/effect/turf_decal/industrial/warning/fulltile,
/obj/structure/catwalk/over/plated_catwalk/dark,
/turf/open/floor/plating,
/area/ship/engineering/engine)
"DL" = (
/obj/structure/catwalk/over,
/obj/machinery/light/floor,
/turf/open/floor/plating/airless,
/area/ship/external)
"Ee" = (
/obj/structure/window/reinforced{
	dir = 1
	},
/obj/structure/curtain/bounty,
/obj/structure/table/wood/reinforced,
/obj/item/canvas/twentythreeXtwentythree,
/obj/item/toy/crayon/spraycan,
/obj/item/reagent_containers/glass/rag{
	name = "handkerchief";
	desc = "A rag for personal hygiene. It's pristinely white."
	},
/obj/item/grown/sunflower,
/obj/item/reagent_containers/food/snacks/grown/ash_flora/fireblossom,
/obj/effect/turf_decal/siding/wood{
	dir = 5
	},
/obj/item/gun/energy/kalix/pistol,
/obj/item/stock_parts/cell/gun/kalix,
/obj/item/gun/ballistic/revolver/shadow,
/obj/item/ammo_box/c45,
/obj/structure/closet/secure_closet/wall/directional/east{
	icon_state = "generic_wall";
	name = "Personal Closet"
	},
/turf/open/floor/wood/ebony,
/area/ship/crew/dorm)
"Em" = (
/obj/effect/turf_decal/techfloor{
	dir = 1
	},
/obj/structure/chair/sofa/red/right/directional/south,
/turf/open/floor/plasteel/tech,
/area/ship/hallway/central)
"EG" = (
/obj/structure/window/reinforced,
/obj/structure/curtain/bounty,
/obj/structure/table/reinforced,
/obj/machinery/reagentgrinder{
	pixel_x = 4;
	pixel_y = 8
	},
/turf/open/floor/plasteel/tech,
/area/ship/hallway/central)
"EJ" = (
/obj/structure/cable,
/obj/structure/catwalk/over,
/obj/machinery/power/smes/engineering,
/turf/open/floor/plating,
/area/ship/engineering/engine)
"Fj" = (
/obj/machinery/holopad/emergency/command,
/obj/structure/cable{
	icon_state = "1-8"
	},
/obj/machinery/atmospherics/pipe/simple/scrubbers/hidden/layer4{
	dir = 9
	},
/obj/machinery/atmospherics/pipe/simple/supply/hidden/layer2{
	dir = 4
	},
/obj/machinery/airalarm/directional/south,
/obj/effect/turf_decal/borderfloorblack/corner,
/obj/effect/turf_decal/trimline/transparent/blue/line{
	dir = 1
	},
/turf/open/floor/plasteel/tech,
/area/ship/bridge)
"Gw" = (
/obj/machinery/atmospherics/components/unary/vent_pump/on/layer2,
/obj/machinery/atmospherics/pipe/simple/scrubbers/hidden/layer4,
/obj/effect/turf_decal/techfloor{
	dir = 1
	},
/obj/machinery/light/directional/east,
/obj/structure/chair/sofa/red/left/directional/south,
/turf/open/floor/plasteel/tech,
/area/ship/hallway/central)
"IY" = (
/obj/structure/chair/plastic,
/obj/effect/turf_decal/spline/fancy/opaque/black{
	dir = 1
	},
/obj/effect/turf_decal/trimline/transparent/green/line{
	dir = 1
	},
/turf/open/floor/plasteel/tech,
/area/ship/hallway/central)
"Jo" = (
/obj/structure/catwalk/over/plated_catwalk/dark,
/obj/structure/cable{
	icon_state = "4-8"
	},
/obj/machinery/atmospherics/pipe/simple/scrubbers/hidden/layer4{
	dir = 4
	},
/obj/machinery/atmospherics/pipe/manifold/supply/hidden/layer2{
	dir = 1
	},
/obj/machinery/airalarm/directional/north,
/turf/open/floor/plating,
/area/ship/hallway/central)
"JZ" = (
/obj/machinery/door/window/southleft,
/obj/structure/curtain,
/obj/structure/mirror{
	pixel_x = -24
	},
/obj/machinery/shower{
	pixel_y = 16;
	pixel_x = 4
	},
/obj/item/reagent_containers/glass/rag,
/obj/effect/turf_decal/steeldecal/steel_decals3{
	dir = 1
	},
/obj/effect/turf_decal/steeldecal/steel_decals3{
	dir = 10
	},
/obj/effect/turf_decal/steeldecal/steel_decals10{
	dir = 8
	},
/obj/effect/turf_decal/steeldecal/steel_decals10,
/obj/item/towel,
/obj/item/soap/deluxe,
/obj/structure/dresser{
	density = 0;
	icon_state = "abductor";
	pixel_x = -14;
	pixel_y = 24;
	icon = 'icons/obj/closet.dmi'
	},
/obj/structure/closet/wall/white/directional/east{
	name = "Soap Cubby"
	},
/turf/open/floor/plasteel/mono/white,
/area/ship/hallway/central)
"Ku" = (
/obj/structure/catwalk/over/plated_catwalk/dark,
/obj/structure/cable{
	icon_state = "4-8"
	},
/obj/machinery/button/door{
	pixel_y = -24;
	pixel_x = 10;
	normaldoorcontrol = 1;
	specialfunctions = 4;
	id = "hotrod_lock";
	name = "entrance lock";
	dir = 1
	},
/obj/item/pickaxe,
/obj/item/radio,
/obj/item/clothing/glasses/meson,
/obj/item/kitchen/knife/combat/survival,
/obj/item/clothing/suit/space/hardsuit/mining/independent,
/obj/item/clothing/mask/gas/sechailer,
/obj/item/flashlight/seclite,
/obj/item/gps,
/obj/item/tank/internals/emergency_oxygen/engi,
/obj/machinery/atmospherics/pipe/simple/scrubbers/hidden/layer4{
	dir = 4
	},
/obj/machinery/atmospherics/pipe/simple/supply/hidden/layer2{
	dir = 4
	},
/obj/item/tank/internals/oxygen/yellow,
/obj/machinery/button/shieldwallgen{
	pixel_x = 10;
	pixel_y = -34;
	dir = 1;
	id = "hotrod_holo"
	},
/obj/item/mining_scanner,
/obj/item/storage/bag/ore,
/obj/structure/closet/secure_closet/wall/directional/south{
	icon_state = "solgov_wall";
	pixel_x = -6;
	name = "Survival Locker"
	},
/turf/open/floor/plating,
/area/ship/hallway/central)
"KR" = (
/obj/docking_port/stationary{
	dir = 2;
	dwidth = 3;
	height = 15;
	width = 6
	},
/turf/template_noop,
/area/template_noop)
"Ml" = (
/obj/structure/catwalk/over/plated_catwalk/dark,
/obj/structure/cable{
	icon_state = "4-8"
	},
/obj/machinery/atmospherics/pipe/manifold/scrubbers/hidden/layer4{
	dir = 1
	},
/obj/machinery/atmospherics/pipe/simple/supply/hidden/layer2{
	dir = 4
	},
/obj/machinery/power/apc/auto_name/directional/north,
/obj/machinery/light_switch{
	pixel_y = 23;
	pixel_x = 10
	},
/obj/structure/cable{
	icon_state = "0-8"
	},
/turf/open/floor/plating,
/area/ship/hallway/central)
"ML" = (
/obj/structure/window/reinforced{
	dir = 1
	},
/obj/structure/curtain/bounty,
/obj/structure/dresser,
/obj/item/clothing/shoes/combat,
/obj/item/clothing/shoes/sneakers/brown,
/obj/item/clothing/glasses/sunglasses/big,
/obj/item/clothing/gloves/fingerless,
/obj/item/clothing/head/beret/black,
/obj/item/clothing/shoes/sandal/slippers{
	name = "slippers"
	},
/obj/item/clothing/suit/hooded/cloak/goliath/polar,
/obj/item/clothing/suit/vapeshirt,
/obj/item/clothing/under/dress/blacktango,
/obj/item/clothing/under/syndicate,
/obj/item/storage/backpack/satchel/explorer,
/obj/item/clothing/suit/armor/roumain,
/obj/effect/turf_decal/siding/wood{
	dir = 9
	},
/obj/structure/closet/wall/directional/west{
	name = "Wardrobe"
	},
/turf/open/floor/wood/ebony,
/area/ship/crew/dorm)
"MO" = (
/obj/structure/cable{
	icon_state = "4-10"
	},
/obj/effect/turf_decal/techfloor/orange/corner,
/obj/machinery/atmospherics/components/unary/vent_pump/on/layer2{
	dir = 4
	},
/obj/effect/turf_decal/trimline/transparent/yellow/line{
	dir = 8
	},
/turf/open/floor/plasteel/tech,
/area/ship/engineering/engine)
"MP" = (
/obj/machinery/door/airlock/external{
	id_tag = "hotrod_lock"
	},
/obj/effect/mapping_helpers/airlock/locked,
/obj/effect/turf_decal/borderfloorblack{
	dir = 1
	},
/obj/effect/turf_decal/borderfloorblack,
/obj/machinery/power/shieldwallgen/atmos/roundstart{
	dir = 2;
	id = "hotrod_holo"
	},
/obj/structure/cable{
	icon_state = "1-2"
	},
/obj/structure/cable,
/turf/open/floor/plasteel/tech/grid,
/area/ship/hallway/central)
"Ne" = (
/obj/effect/turf_decal/techfloor{
	dir = 4
	},
/obj/machinery/computer/cargo/express{
	dir = 8;
	icon_state = "computer-left"
	},
/turf/open/floor/plasteel/telecomms_floor,
/area/ship/bridge)
"Or" = (
/obj/structure/chair/comfy/shuttle{
	dir = 4;
	name = "Driver's Seat"
	},
/obj/machinery/atmospherics/pipe/simple/supply/hidden/layer2{
	dir = 9
	},
/obj/effect/turf_decal/borderfloorblack{
	dir = 6
	},
/obj/effect/turf_decal/trimline/transparent/blue/corner{
	dir = 1
	},
/turf/open/floor/plasteel/tech,
/area/ship/bridge)
"OM" = (
/turf/closed/wall/mineral/plastitanium/nodiagonal,
/area/ship/hallway/central)
"OQ" = (
/obj/structure/catwalk/over/plated_catwalk/dark,
/obj/structure/cable{
	icon_state = "4-8"
	},
/obj/machinery/atmospherics/pipe/manifold/scrubbers/hidden/layer4,
/obj/machinery/atmospherics/pipe/simple/supply/hidden/layer2{
	dir = 4
	},
/turf/open/floor/plating,
/area/ship/hallway/central)
"OR" = (
/turf/closed/wall/mineral/plastitanium/nodiagonal,
/area/ship/engineering/engine)
"Pw" = (
/obj/structure/catwalk/over/plated_catwalk/dark,
/obj/structure/cable{
	icon_state = "4-8"
	},
/obj/structure/cable{
	icon_state = "1-8"
	},
/obj/machinery/atmospherics/pipe/manifold/scrubbers/hidden/layer4,
/obj/machinery/atmospherics/pipe/manifold/supply/hidden/layer2,
/turf/open/floor/plating,
/area/ship/hallway/central)
"PL" = (
/turf/closed/wall/mineral/plastitanium/nodiagonal,
/area/ship/crew/dorm)
"Qe" = (
/obj/structure/cable{
	icon_state = "1-2"
	},
/obj/effect/turf_decal/techfloor/orange,
/obj/structure/cable{
	icon_state = "2-4"
	},
/obj/structure/cable{
	icon_state = "2-8"
	},
/obj/structure/cable{
	icon_state = "2-9"
	},
/obj/machinery/atmospherics/pipe/simple/scrubbers/hidden/layer4{
	dir = 5
	},
/obj/machinery/atmospherics/pipe/manifold/supply/hidden/layer2,
/turf/open/floor/plasteel/tech,
/area/ship/engineering/engine)
"Qu" = (
/obj/machinery/power/apc/auto_name/directional/east,
/obj/structure/cable{
	icon_state = "0-2"
	},
/obj/machinery/atmospherics/pipe/simple/scrubbers/hidden/layer4{
	dir = 10
	},
/obj/machinery/atmospherics/components/binary/pump/layer2{
	name = "Air to Distro"
	},
/obj/machinery/light_switch{
	dir = 8;
	pixel_x = 20;
	pixel_y = -10
	},
/obj/effect/turf_decal/trimline/transparent/yellow/line{
	dir = 1
	},
/turf/open/floor/plasteel/tech,
/area/ship/engineering/engine)
"QK" = (
/obj/machinery/cryopod{
	dir = 1
	},
/obj/structure/curtain/bounty,
/obj/item/clothing/suit/space,
/obj/item/clothing/head/helmet/space,
/obj/item/tank/internals/emergency_oxygen,
/obj/item/tank/internals/oxygen,
/obj/item/clothing/mask/breath,
/obj/item/storage/firstaid/o2,
/obj/item/storage/toolbox/emergency,
/obj/structure/extinguisher_cabinet/directional/south{
	pixel_x = -6
	},
/obj/machinery/firealarm/directional/south{
	pixel_x = 6
	},
/obj/effect/turf_decal/spline/fancy/opaque/black{
	dir = 1
	},
/obj/structure/closet/wall/directional/west{
	icon_state = "emergency_wall";
	name = "Emergency Closet"
	},
/turf/open/floor/plasteel/tech/grid,
/area/ship/hallway/central)
"Rd" = (
/obj/structure/window/reinforced,
/obj/structure/curtain/bounty,
/obj/structure/table/reinforced,
/obj/machinery/microwave{
	pixel_y = 6;
	pixel_x = 2
	},
/obj/effect/turf_decal/techfloor{
	dir = 4
	},
/obj/machinery/firealarm/directional/east,
/turf/open/floor/plasteel/tech,
/area/ship/hallway/central)
"RY" = (
/obj/structure/catwalk/over,
/obj/machinery/atmospherics/components/unary/tank/air,
/obj/machinery/light/small/directional/east,
/turf/open/floor/plating,
/area/ship/engineering/engine)
"Ug" = (
/obj/structure/cable{
	icon_state = "2-4"
	},
/obj/machinery/atmospherics/pipe/simple/scrubbers/hidden/layer4{
	dir = 6
	},
/obj/machinery/atmospherics/pipe/simple/supply/hidden/layer2{
	dir = 10
	},
/obj/effect/turf_decal/siding/wood,
/turf/open/floor/wood/ebony,
/area/ship/crew/dorm)
"Ul" = (
/obj/structure/table,
/obj/item/stack/sheet/mineral/plasma/twenty,
/obj/structure/cable/yellow{
	icon_state = "1-4"
	},
/obj/structure/cable{
	icon_state = "8-9"
	},
/obj/machinery/cell_charger{
	pixel_x = -2;
	pixel_y = 1
	},
/obj/effect/turf_decal/techfloor,
/obj/effect/turf_decal/techfloor/orange{
	dir = 4
	},
/obj/effect/turf_decal/trimline/transparent/yellow/line{
	dir = 8
	},
/obj/structure/closet/wall/orange/directional/south{
	name = "Fuel Bin"
	},
/turf/open/floor/plasteel/tech,
/area/ship/engineering/engine)
"Vz" = (
/obj/structure/catwalk/over,
/obj/machinery/light/floor,
/obj/docking_port/mobile{
	can_move_docking_ports = 1;
	dir = 2;
	launch_status = 0;
	port_direction = 8;
	preferred_direction = 4;
	dwidth = 8;
	dheight = 2
	},
/turf/open/floor/plating/airless,
/area/ship/external)
"VJ" = (
/obj/machinery/atmospherics/components/unary/outlet_injector/on,
/obj/effect/turf_decal/industrial/caution{
	dir = 1;
	pixel_y = -6
	},
/obj/effect/turf_decal/industrial/warning{
	dir = 1
	},
/turf/open/floor/engine/hull/reinforced,
/area/ship/external)
"Wb" = (
/obj/item/storage/box/gloves,
/obj/item/reagent_containers/medigel/silver_sulf,
/obj/item/reagent_containers/medigel/styptic,
/obj/item/stack/medical/suture,
/obj/item/stack/medical/suture,
/obj/item/stack/medical/mesh,
/obj/item/stack/medical/mesh,
/obj/item/stack/medical/splint,
/obj/item/stack/medical/gauze/twelve,
/obj/item/healthanalyzer,
/obj/item/reagent_containers/spray/rhigoxane,
/obj/item/storage/pill_bottle/charcoal,
/obj/item/storage/pill_bottle/iron,
/obj/item/reagent_containers/hypospray/medipen/salbutamol,
/obj/item/reagent_containers/hypospray/medipen,
/obj/item/storage/box/masks,
/obj/item/storage/bag/medical,
/obj/machinery/atmospherics/components/unary/vent_scrubber/on/layer4,
/obj/effect/turf_decal/techfloor/corner{
	dir = 4
	},
/obj/structure/closet/secure_closet/wall/directional/west{
	icon_door = "med_wall";
	name = "Medicine Cabinet"
	},
/turf/open/floor/plasteel/tech,
/area/ship/hallway/central)
"Xb" = (
/obj/structure/bed/double,
/obj/item/bedsheet/double/purple,
/obj/structure/cable{
	icon_state = "0-8"
	},
/obj/machinery/power/apc/auto_name/directional/south,
/obj/machinery/atmospherics/components/unary/vent_scrubber/on/layer4{
	dir = 8
	},
/obj/machinery/light/directional/east,
/obj/machinery/light_switch{
	dir = 1;
	pixel_y = -16;
	pixel_x = 10
	},
/obj/effect/turf_decal/siding/wood{
	dir = 6
	},
/turf/open/floor/wood/ebony,
/area/ship/crew/dorm)
"Xt" = (
/obj/structure/table/reinforced,
/obj/machinery/fax{
	pixel_y = 10;
	pixel_x = -3
	},
/obj/machinery/power/apc/auto_name/directional/west,
/obj/structure/cable{
	icon_state = "0-2"
	},
/obj/machinery/atmospherics/components/unary/vent_scrubber/on/layer4,
/obj/machinery/light/directional/north,
/obj/machinery/light_switch{
	dir = 4;
	pixel_x = -20;
	pixel_y = 10
	},
/obj/item/storage/fancy/cigarettes/cigpack_midori{
	pixel_x = -1;
	pixel_y = 6
	},
/obj/item/storage/fancy/cigarettes/cigpack_syndicate{
	pixel_y = 2;
	pixel_x = -6
	},
/obj/item/lighter{
	pixel_y = -2;
	pixel_x = 2
	},
/obj/effect/turf_decal/borderfloorblack/corner{
	dir = 4
	},
/obj/effect/turf_decal/trimline/transparent/blue/line,
/obj/machinery/firealarm/directional/north,
/turf/open/floor/plasteel/tech,
/area/ship/bridge)
"XJ" = (
/obj/structure/cable/yellow{
	icon_state = "0-8"
	},
/obj/structure/catwalk/over,
/obj/machinery/power/port_gen/pacman{
	anchored = 1
	},
/obj/machinery/light/small/directional/east,
/turf/open/floor/plating,
/area/ship/engineering/engine)
"Yu" = (
/obj/machinery/door/airlock/hatch{
	dir = 4
	},
/obj/structure/cable{
	icon_state = "4-8"
	},
/obj/machinery/atmospherics/pipe/simple/scrubbers/hidden/layer4{
	dir = 4
	},
/obj/machinery/atmospherics/pipe/simple/supply/hidden/layer2{
	dir = 4
	},
/obj/machinery/door/firedoor/border_only{
	dir = 4
	},
/obj/machinery/door/firedoor/border_only{
	dir = 8
	},
/obj/effect/turf_decal/borderfloorblack{
	dir = 4
	},
/obj/effect/turf_decal/borderfloorblack{
	dir = 8
	},
/turf/open/floor/plasteel/tech/grid,
/area/ship/hallway/central)
"ZV" = (
/obj/machinery/power/terminal{
	dir = 8
	},
/obj/structure/cable{
	icon_state = "0-4"
	},
/obj/machinery/light/small/directional/south,
/obj/effect/turf_decal/industrial/warning/fulltile,
/obj/structure/catwalk/over/plated_catwalk/dark,
/turf/open/floor/plating,
/area/ship/engineering/engine)

(1,1,1) = {"
ug
Bf
Bf
OR
OR
Bf
Bf
ug
"}
(2,1,1) = {"
OR
ar
qc
OR
OR
ar
qc
OR
"}
(3,1,1) = {"
OR
CI
rG
dL
oZ
tt
ZV
OR
"}
(4,1,1) = {"
OR
iJ
dq
iD
MO
ju
Ul
OR
"}
(5,1,1) = {"
OR
RY
pG
Qu
Qe
EJ
XJ
OR
"}
(6,1,1) = {"
ug
OR
OR
OR
na
OR
OR
ug
"}
(7,1,1) = {"
BO
OM
JZ
Wb
OQ
QK
OM
BO
"}
(8,1,1) = {"
BO
OM
OM
Em
Ku
OM
OM
BO
"}
(9,1,1) = {"
BO
VJ
mc
Gw
pS
MP
fI
KR
"}
(10,1,1) = {"
BO
PL
PL
PL
Yu
OM
OM
BO
"}
(11,1,1) = {"
BO
ML
Co
PL
Ml
fg
aV
BO
"}
(12,1,1) = {"
BO
ls
Ug
wj
Pw
IY
EG
BO
"}
(13,1,1) = {"
nD
Ee
Xb
PL
Jo
em
Rd
dm
"}
(14,1,1) = {"
dU
PL
qR
qR
bj
qR
OM
zs
"}
(15,1,1) = {"
af
BO
qR
Xt
Fj
qR
BO
lK
"}
(16,1,1) = {"
DL
BO
jG
eH
Or
jG
BO
Vz
"}
(17,1,1) = {"
BO
BO
jG
Ne
Bv
jG
BO
BO
"}
(18,1,1) = {"
BO
BO
jG
px
px
jG
BO
BO
"}
